●●●●●○●●●●●○●●●●●○●●●●○○●●●●●○○○●○○○○○○○○○○●●●●○●●○●●●
○○●○○○○○●○○○○○●○○○○●○○●○○●○○●○○○●○○○○○○○○○●○○○●○○●○○●○
○○●○○○○○●○○○○○●○○○○●○○●○○●○●○○○○●●○○○○○○○○●○○○○○○●●○●○
○○●○○○○○●○○○○○●○○○○●○○●○○●●●○○○●○●○○○○○○○○●○○○○○○●●○●○
○○●○○○○○●○○○○○●○○○○●○○●○○●○●○○○●○●○○○○○○○○●○○○○○○●○●●○
○○●○○○○○●○○○○○●○○○○●○○●○○●○○○○○●●●●○○○○○○○●○○○○○○●○●●○
○○●○○○○○●○○○○○●○○○○●○○●○○●○○●○○●○○●○○○○○○○●○○○●○○●○○●○
●●●●●○●●●●●○●●●●●○●●●●○○●●●●●○●●○○●●○●○○○○○●●●○○●●●○●○


爱创意 爱学习 爱分享!!!百度网盘下载 !

如果对你有帮助请支持作者购买正版，请点击文章中由工作人员指引的
演示链接地址购买正版，支持作者发展··

基于对iiidea.cn的尊重,转载请注明出处.谢谢！

更多正版优秀资源请访问
iiidea.cn官网：http://iiidea.cn


官方QQ群：136554393       验证:3dmax
官方QQ咨询：1397089828
